NO textures/horror4.xpm
WE textures/horror2.xpm    
EA textures/horror3.xpm		
SO textures/horror1.xpm

F 5,5,5		
C 124,10,2
111111111111111111
111111000000000001
100000000110011001
100001100000000001
100001100110011001
101110000000000001
100111100000000111
110110000000000001
110011110001000111
111010000001000001
111011111101011111
10E010000000010101
111111111111111111
